DATE,TYPE,REF #,DESCRIPTION,FEES,AMOUNT,BALANCE
2014-07-12,DIV,33403638,ORDINARY DIVIDEND~MSFX,0,16.64,3963.83
2014-07-28,DIV,23571586,ORDINARY DIVIDEND~CSKO,0,15.60,3979.43
2014-08-07,BUY,90404110,BOUGHT +CSKO 48 @52.93,7.95,-2548.59,1430.84
2014-08-22,DIV,70106713,ORDINARY DIVIDEND~HOOL,0,22.58,1453.42
2014-08-26,DIV,18874360,ORDINARY DIVIDEND~CSKO,0,8.46,1461.88
2014-09-24,DIV,18146488,ORDINARY DIVIDEND~CSKO,0,7.36,1469.24
