DATE,TYPE,REF #,DESCRIPTION,FEES,AMOUNT,BALANCE
2015-09-13,DIV,74624169,ORDINARY DIVIDEND~CSKO,0,12.47,1015.31
2015-09-19,DIV,86506548,ORDINARY DIVIDEND~MSFX,0,14.07,1029.38
2015-10-21,DIV,71819731,ORDINARY DIVIDEND~HOOL,0,7.98,1037.36
2015-10-26,DIV,99810091,ORDINARY DIVIDEND~HOOL,0,16.83,1054.19
2015-11-15,DIV,84191955,ORDINARY DIVIDEND~BAPL,0,22.75,1076.94
2015-11-17,SELL,35166597,SOLD +MSFX 41 @84.22 (LOT 93.91),7.95,3445.07,4522.01
2015-12-03,DIV,48233019,ORDINARY DIVIDEND~CSKO,0,9.01,4531.02
